//MAP CONVERTED BY dmm2tgm.py THIS HEADER COMMENT PREVENTS RECONVERSION, DO NOT REMOVE
"a" = (
/obj/structure/sign/property_sign/claim,
/turf/closed/wall/mineral/decowood,
/area/indoors/town)
"h" = (
/obj/structure/bed/mediocre,
/obj/item/bedsheet/cloth,
/turf/open/floor/ruinedwood/darker,
/area/indoors/town)
"l" = (
/obj/structure/table/wood/plain_alt,
/turf/open/floor/ruinedwood/darker,
/area/indoors/town)
"p" = (
/obj/structure/rack/shelf/biggest,
/turf/open/floor/ruinedwood/darker,
/area/indoors/town)
"t" = (
/obj/structure/table/wood/plain_alt,
/obj/item/reagent_containers/glass/cup/wooden,
/turf/open/floor/ruinedwood/darker,
/area/indoors/town)
"u" = (
/obj/structure/chair/wood/alt{
	dir = 4
	},
/turf/open/floor/ruinedwood/darker,
/area/indoors/town)
"w" = (
/obj/structure/closet/crate/crafted_closet/inn,
/obj/item/broom,
/turf/open/floor/ruinedwood/darker,
/area/indoors/town)
"y" = (
/turf/closed/wall/mineral/wooddark/slitted,
/area/indoors/town)
"C" = (
/obj/structure/door,
/turf/open/floor/ruinedwood/darker,
/area/indoors/town)
"J" = (
/obj/machinery/light/fueled/wallfire/candle{
	pixel_y = -32
	},
/turf/open/floor/ruinedwood/darker,
/area/indoors/town)
"N" = (
/turf/open/floor/ruinedwood/darker,
/area/indoors/town)
"R" = (
/turf/closed/wall/mineral/decowood,
/area/indoors/town)
"V" = (
/obj/machinery/light/fueled/wallfire/candle/r,
/turf/open/floor/ruinedwood/darker,
/area/indoors/town)

(1,1,1) = {"
R
R
a
C
R
R
"}
(2,1,1) = {"
R
w
N
N
N
R
"}
(3,1,1) = {"
R
p
N
N
J
R
"}
(4,1,1) = {"
R
N
N
u
N
R
"}
(5,1,1) = {"
y
h
V
l
t
R
"}
(6,1,1) = {"
y
R
R
R
R
y
"}
