//MAP CONVERTED BY dmm2tgm.py THIS HEADER COMMENT PREVENTS RECONVERSION, DO NOT REMOVE
"ah" = (
/obj/item/flashlight/flare/torch/metal,
/turf/open/floor/naturalstone,
/area/under/tomb/cave)
"az" = (
/obj/structure/closet/dirthole/closed,
/mob/living/carbon/human/species/skeleton/npc/ambush,
/obj/effect/spawner/map_spawner/loot/rare,
/obj/effect/mapping_helpers/structure/grave_spawner/t2,
/turf/open/floor/dirt,
/area/under/tomb)
"aG" = (
/obj/item/natural/rock,
/turf/open/floor/naturalstone,
/area/under/tomb/cave)
"aH" = (
/turf/open/floor/naturalstone,
/area/under/tomb/cave)
"bd" = (
/obj/structure/chair/stool,
/mob/living/carbon/human/species/rousman/npc{
	name = "Spoon Sharpener"
	},
/obj/effect/mapping_helpers/floor_clothing_equipper,
/obj/item/kitchen/spoon/iron,
/obj/item/kitchen/spoon/iron,
/turf/open/floor/naturalstone,
/area/under/tomb/cave)
"bo" = (
/obj/structure/pillory/double,
/turf/open/floor/naturalstone,
/area/under/tomb/cave)
"cc" = (
/obj/structure/closet/dirthole/grave,
/obj/item/weapon/shovel,
/turf/open/floor/dirt/road,
/area/under/tomb)
"dr" = (
/obj/item/natural/stone,
/turf/open/floor/naturalstone,
/area/under/tomb/cave)
"dE" = (
/obj/structure/closet/dirthole/closed,
/mob/living/carbon/human/species/skeleton/npc/no_equipment,
/obj/effect/spawner/map_spawner/loot/weapon,
/obj/effect/mapping_helpers/floor_clothing_equipper,
/obj/effect/spawner/map_spawner/loot/armor,
/obj/effect/mapping_helpers/structure/grave_spawner/t2,
/turf/open/floor/dirt,
/area/under/tomb)
"ew" = (
/obj/structure/closet/dirthole/closed,
/obj/item/clothing/neck/gorget/copper,
/obj/item/clothing/head/helmet/coppercap,
/mob/living/carbon/human/species/skeleton/npc/ambush,
/obj/effect/mapping_helpers/structure/grave_spawner/t2,
/turf/open/floor/dirt,
/area/under/tomb)
"eK" = (
/obj/item/natural/stone{
	pixel_x = 2;
	pixel_y = -8
	},
/turf/open/floor/naturalstone,
/area/under/tomb/cave)
"eL" = (
/obj/effect/spawner/map_spawner/beartrap,
/turf/open/floor/naturalstone,
/area/under/tomb/cave)
"fm" = (
/obj/item/natural/rock/random,
/turf/open/floor/dirt/road,
/area/under/tomb/cave)
"fy" = (
/obj/structure/closet/dirthole,
/turf/open/floor/dirt/road,
/area/under/tomb)
"gp" = (
/obj/item/weapon/shovel,
/turf/open/floor/dirt,
/area/under/tomb)
"gT" = (
/obj/item/natural/rock/gold,
/turf/open/floor/cobblerock,
/area/under/tomb/cave)
"gZ" = (
/obj/item/clothing/head/jester,
/obj/item/clothing/shoes/jester,
/obj/item/clothing/shirt/jester,
/obj/item/clothing/pants/tights/colored/jester,
/obj/effect/mapping_helpers/floor_clothing_equipper,
/obj/item/handheld_bell,
/mob/living/carbon/human/species/skeleton/npc/no_equipment,
/obj/item/kitchen/fork/iron,
/turf/open/floor/naturalstone,
/area/under/tomb/cave)
"hQ" = (
/obj/structure/flora/grass/bush_meagre,
/turf/open/floor/grass/yel,
/area/under/tomb/cave)
"hY" = (
/obj/structure/closet/dirthole/closed,
/obj/effect/spawner/map_spawner/loot/armor,
/mob/living/carbon/human/species/skeleton/npc/ambush,
/obj/structure/closet/burial_shroud,
/obj/effect/mapping_helpers/structure/grave_spawner/t2,
/turf/open/floor/dirt/road,
/area/under/tomb)
"if" = (
/obj/structure/closet/dirthole/closed,
/obj/structure/closet/burial_shroud,
/mob/living/carbon/human/species/skeleton/npc/ambush,
/obj/effect/spawner/map_spawner/loot/weapon,
/obj/effect/mapping_helpers/structure/grave_spawner/t2,
/turf/open/floor/dirt,
/area/under/tomb)
"in" = (
/turf/open/floor/dirt,
/area/under/tomb)
"ip" = (
/obj/item/natural/clod/dirt,
/turf/open/floor/dirt/road,
/area/under/tomb)
"iv" = (
/obj/structure/closet/dirthole/grave,
/obj/structure/closet/crate/coffin,
/obj/item/organ/guts,
/obj/item/organ/lungs,
/obj/item/organ/heart,
/obj/item/organ/tongue,
/obj/item/organ/brain,
/turf/open/floor/dirt,
/area/under/tomb)
"iL" = (
/obj/structure/flora/grass/maneater,
/turf/open/floor/dirt/road,
/area/under/tomb/cave)
"iR" = (
/turf/closed/mineral/bedrock,
/area/under/tomb)
"jc" = (
/obj/effect/dungeon_directional_helper/east,
/turf/open/floor/grass/yel,
/area/under/tomb/cave)
"kh" = (
/obj/structure/roguerock,
/turf/open/floor/dirt,
/area/under/tomb/cave)
"kp" = (
/turf/open/water/swamp,
/area/under/tomb)
"lA" = (
/obj/structure/closet/dirthole/grave,
/turf/open/floor/dirt,
/area/under/tomb)
"mj" = (
/obj/structure/closet/dirthole/closed,
/obj/effect/spawner/map_spawner/loot/common,
/obj/structure/closet/burial_shroud,
/obj/item/weapon/sword/coppermesser,
/mob/living/carbon/human/species/skeleton/npc/ambush,
/obj/effect/mapping_helpers/structure/grave_spawner/t2,
/turf/open/floor/dirt,
/area/under/tomb)
"mu" = (
/obj/structure/roguerock,
/turf/open/floor/naturalstone,
/area/under/tomb/cave)
"mJ" = (
/obj/structure/flora/grass/herb/atropa,
/turf/open/floor/grass/yel,
/area/under/tomb/cave)
"mN" = (
/obj/item/natural/stone{
	pixel_x = 9;
	pixel_y = 5
	},
/turf/open/floor/cobblerock,
/area/under/tomb/cave)
"nB" = (
/turf/closed/wall/mineral/decostone,
/area/under/tomb)
"oB" = (
/obj/structure/stairs/stone{
	dir = 1
	},
/turf/open/floor/herringbone,
/area/under/tomb/cave)
"oM" = (
/mob/living/carbon/human/species/skeleton/npc/warrior/skilled,
/obj/effect/spawner/map_spawner/loot/rare,
/obj/structure/closet/dirthole/closed,
/obj/item/clothing/head/peaceflower{
	pixel_y = -10;
	pixel_x = -8
	},
/obj/item/reagent_containers/food/snacks/produce/poppy{
	pixel_x = 9
	},
/obj/effect/mapping_helpers/structure/grave_spawner/t3,
/turf/open/floor/dirt,
/area/under/tomb)
"pr" = (
/turf/open/floor/herringbone,
/area/under/tomb/cave)
"qH" = (
/obj/item/natural/clod/dirt,
/turf/open/floor/dirt,
/area/under/tomb)
"rp" = (
/turf/closed/wall/mineral/decostone/end{
	dir = 8
	},
/area/under/tomb/cave)
"rr" = (
/obj/structure/closet/dirthole/closed,
/obj/item/clothing/armor/cuirass/copperchest,
/obj/effect/mapping_helpers/structure/grave_spawner/t2,
/turf/open/floor/dirt,
/area/under/tomb)
"si" = (
/obj/structure/flora/ausbushes/reedbush,
/turf/open/water/swamp,
/area/under/tomb/cave)
"sF" = (
/obj/structure/closet/dirthole/closed,
/obj/item/weapon/mace/spiked,
/obj/effect/mapping_helpers/structure/grave_spawner/t2,
/turf/open/floor/dirt,
/area/under/tomb)
"tc" = (
/turf/closed/wall/mineral/decostone/end{
	dir = 4
	},
/area/under/tomb/cave)
"tW" = (
/obj/item/natural/stone{
	pixel_x = -3;
	pixel_y = 5
	},
/turf/open/floor/naturalstone,
/area/under/tomb/cave)
"vd" = (
/obj/effect/decal/cleanable/blood/splatter,
/turf/open/floor/naturalstone,
/area/under/tomb/cave)
"vg" = (
/turf/open/floor/cobblerock,
/area/under/tomb/cave)
"vl" = (
/obj/structure/kneestingers,
/turf/open/water/swamp,
/area/under/tomb/cave)
"vH" = (
/obj/effect/dungeon_directional_helper/north,
/turf/open/floor/dirt/road,
/area/under/tomb)
"wj" = (
/obj/structure/kneestingers{
	icon_state = "glowshroom2"
	},
/turf/open/water/swamp,
/area/under/tomb/cave)
"wu" = (
/obj/structure/closet/dirthole/closed,
/mob/living/carbon/human/species/skeleton/npc/ambush,
/obj/effect/mapping_helpers/structure/grave_spawner,
/turf/open/floor/dirt,
/area/under/tomb)
"xc" = (
/obj/structure/roguerock,
/turf/open/floor/dirt/road,
/area/under/tomb/cave)
"xy" = (
/obj/structure/closet/dirthole/closed,
/obj/effect/spawner/map_spawner/loot/common,
/mob/living/carbon/human/species/skeleton/npc/warrior,
/obj/effect/mapping_helpers/structure/grave_spawner/t2,
/turf/open/floor/dirt/road,
/area/under/tomb)
"xP" = (
/obj/structure/closet/dirthole/closed,
/obj/effect/mapping_helpers/structure/grave_spawner/t2,
/turf/open/floor/dirt,
/area/under/tomb)
"yG" = (
/obj/structure/closet/dirthole/closed,
/mob/living/carbon/human/species/skeleton/npc/warrior/skilled,
/obj/effect/spawner/map_spawner/loot/armor,
/obj/effect/mapping_helpers/structure/grave_spawner/t2,
/turf/open/floor/dirt,
/area/under/tomb)
"yN" = (
/turf/closed/mineral,
/area/under/tomb/cave)
"zU" = (
/obj/item/natural/stone{
	pixel_x = -6;
	pixel_y = -7
	},
/obj/item/natural/stone{
	pixel_x = 9;
	pixel_y = 5
	},
/turf/open/floor/naturalstone,
/area/under/tomb/cave)
"At" = (
/obj/item/clothing/cloak/raincloak/colored/mortus,
/turf/open/floor/dirt/road,
/area/under/tomb)
"AF" = (
/obj/item/grown/log/tree/small,
/turf/closed/mineral/bedrock,
/area/under/tomb)
"AG" = (
/obj/structure/closet/dirthole/closed,
/obj/effect/mapping_helpers/structure/grave_spawner/t2,
/turf/open/floor/dirt/road,
/area/under/tomb)
"AQ" = (
/obj/item/restraints/legcuffs/beartrap/armed/camouflage,
/turf/open/floor/naturalstone,
/area/under/tomb/cave)
"Bh" = (
/obj/structure/kneestingers{
	icon_state = "glowshroom_A3"
	},
/turf/open/floor/dirt,
/area/under/tomb/cave)
"BF" = (
/obj/structure/roguerock,
/turf/open/floor/cobblerock,
/area/under/tomb/cave)
"Cj" = (
/obj/item/ingot/gold,
/obj/item/ingot/gold{
	pixel_x = 8;
	pixel_y = -4
	},
/obj/item/ingot/gold{
	pixel_x = 4;
	pixel_y = 3
	},
/turf/open/water/swamp/deep,
/area/under/tomb/cave)
"Co" = (
/obj/effect/decal/cleanable/blood/old,
/turf/open/floor/naturalstone,
/area/under/tomb/cave)
"Cq" = (
/obj/item/natural/rock,
/turf/open/floor/cobblerock,
/area/under/tomb/cave)
"CI" = (
/obj/structure/kneestingers,
/turf/open/floor/dirt,
/area/under/tomb/cave)
"CM" = (
/turf/open/floor/dirt/road,
/area/under/tomb/cave)
"CZ" = (
/obj/structure/closet/dirthole/closed,
/obj/effect/mapping_helpers/structure/grave_spawner,
/turf/open/floor/dirt,
/area/under/tomb)
"De" = (
/obj/effect/mapping_helpers/structure/grave_spawner,
/turf/closed/mineral/bedrock,
/area/under/tomb)
"Dz" = (
/obj/effect/decal/cleanable/blood/splatter,
/turf/open/floor/cobblerock,
/area/under/tomb/cave)
"DA" = (
/obj/structure/closet/dirthole/grave,
/obj/structure/closet/burial_shroud,
/obj/item/weapon/shield/wood,
/turf/open/floor/dirt/road,
/area/under/tomb)
"DH" = (
/obj/item/natural/stone{
	pixel_x = 6;
	pixel_y = -5
	},
/obj/item/natural/stone{
	pixel_x = -3;
	pixel_y = 7
	},
/turf/open/floor/naturalstone,
/area/under/tomb/cave)
"Ei" = (
/obj/item/kitchen/spoon/iron{
	pixel_y = 3;
	pixel_x = 7
	},
/obj/item/kitchen/spoon/iron{
	pixel_x = -1;
	pixel_y = 4
	},
/obj/item/kitchen/spoon/iron{
	pixel_x = -3;
	pixel_y = -1
	},
/obj/item/kitchen/spoon/iron{
	pixel_x = 3
	},
/obj/item/kitchen/spoon/iron{
	pixel_x = -8;
	pixel_y = 3
	},
/turf/open/floor/naturalstone,
/area/under/tomb/cave)
"Eq" = (
/obj/item/natural/stone{
	pixel_x = 9;
	pixel_y = 5
	},
/obj/item/natural/stone{
	pixel_x = -6;
	pixel_y = -7
	},
/turf/open/floor/naturalstone,
/area/under/tomb/cave)
"EP" = (
/mob/living/carbon/human/species/skeleton/npc/ambush,
/turf/open/water/swamp/deep,
/area/under/tomb/cave)
"Ft" = (
/mob/living/carbon/human/species/skeleton/npc/ambush,
/turf/open/floor/dirt/road,
/area/under/tomb)
"Fy" = (
/obj/structure/kneestingers{
	icon_state = "glowshroom_A1"
	},
/turf/open/floor/dirt,
/area/under/tomb/cave)
"GC" = (
/turf/open/water/swamp/deep,
/area/under/tomb/cave)
"GJ" = (
/obj/effect/dungeon_directional_helper/west,
/turf/open/floor/dirt/road,
/area/under/tomb/cave)
"IB" = (
/obj/item/natural/rock/random,
/turf/open/floor/naturalstone,
/area/under/tomb/cave)
"IP" = (
/obj/machinery/light/fueled/firebowl/standing/blue,
/turf/open/floor/dirt/road,
/area/under/tomb)
"Js" = (
/turf/open/openspace,
/area/under/tomb/cave)
"Lx" = (
/obj/structure/closet/dirthole/grave,
/turf/open/floor/dirt/road,
/area/under/tomb)
"Ly" = (
/obj/structure/closet/dirthole/grave,
/obj/structure/closet/burial_shroud,
/mob/living/carbon/human/species/skeleton/npc/no_equipment,
/obj/effect/mapping_helpers/structure/grave_spawner/t2,
/turf/open/floor/dirt,
/area/under/tomb)
"Lz" = (
/obj/structure/fluff/clodpile/dirt,
/turf/open/floor/dirt,
/area/under/tomb)
"MV" = (
/obj/effect/decal/cleanable/blood/old,
/obj/effect/spawner/map_spawner/beartrap,
/turf/open/floor/naturalstone,
/area/under/tomb/cave)
"MX" = (
/obj/structure/grindwheel,
/turf/open/floor/naturalstone,
/area/under/tomb/cave)
"Nq" = (
/turf/open/water/swamp,
/area/under/tomb/cave)
"Nr" = (
/obj/machinery/light/fueled/torchholder/r,
/turf/open/floor/naturalstone,
/area/under/tomb/cave)
"NC" = (
/turf/open/floor/grass/yel,
/area/under/tomb/cave)
"Oh" = (
/obj/item/natural/rock/gemerald,
/turf/open/floor/cobblerock,
/area/under/tomb/cave)
"OL" = (
/obj/structure/kneestingers{
	icon_state = "glowshroom_A2"
	},
/turf/open/floor/dirt,
/area/under/tomb/cave)
"OW" = (
/obj/structure/closet/dirthole/closed,
/mob/living/carbon/human/species/skeleton/npc/ambush,
/obj/effect/mapping_helpers/structure/grave_spawner,
/turf/open/floor/dirt/road,
/area/under/tomb)
"Pt" = (
/obj/effect/spawner/map_spawner/beartrap,
/turf/open/floor/cobblerock,
/area/under/tomb/cave)
"Qk" = (
/obj/structure/closet/dirthole/closed,
/obj/effect/landmark/chest_or_mimic,
/obj/item/gem,
/obj/effect/mapping_helpers/structure/grave_spawner/t3,
/turf/open/floor/dirt,
/area/under/tomb)
"Rk" = (
/obj/structure/closet/dirthole/closed,
/obj/item/weapon/shield/wood,
/obj/effect/mapping_helpers/structure/grave_spawner/t2,
/turf/open/floor/dirt/road,
/area/under/tomb)
"Sk" = (
/obj/structure/stairs/stone,
/turf/open/floor/herringbone,
/area/under/tomb/cave)
"SP" = (
/obj/structure/kneestingers{
	icon_state = "glowshroom2"
	},
/turf/open/floor/dirt,
/area/under/tomb/cave)
"SY" = (
/obj/effect/dungeon_directional_helper/south,
/turf/open/floor/dirt/road,
/area/under/tomb)
"To" = (
/turf/open/floor/dirt,
/area/under/tomb/cave)
"Ts" = (
/obj/structure/closet/dirthole/closed,
/obj/item/weapon/shield/tower,
/obj/item/weapon/mace/bludgeon/copper,
/obj/effect/mapping_helpers/floor_clothing_equipper,
/mob/living/carbon/human/species/skeleton/npc/no_equipment,
/obj/effect/mapping_helpers/structure/grave_spawner/t2,
/turf/open/floor/dirt,
/area/under/tomb)
"TC" = (
/mob/living/carbon/human/species/skeleton/npc/no_equipment,
/obj/effect/mapping_helpers/floor_clothing_equipper,
/obj/item/weapon/shovel,
/obj/item/clothing/pants/trou/leather/mourning,
/obj/item/clothing/shirt/robe/necra,
/obj/item/clothing/head/padded/deathshroud,
/obj/item/clothing/neck/psycross/silver/divine/necra,
/turf/open/floor/dirt/road,
/area/under/tomb)
"Vc" = (
/obj/structure/flora/grass/bush,
/turf/open/floor/grass/yel,
/area/under/tomb/cave)
"Wk" = (
/mob/living/carbon/human/species/skeleton/npc/no_equipment,
/obj/item/weapon/shovel,
/obj/item/clothing/head/padded/deathshroud,
/obj/effect/mapping_helpers/floor_clothing_equipper,
/obj/item/clothing/pants/trou/leather/mourning,
/obj/item/clothing/shirt/robe/necra,
/turf/open/floor/dirt/road,
/area/under/tomb)
"WI" = (
/obj/structure/kneestingers{
	icon_state = "glowshroom3"
	},
/turf/open/water/swamp,
/area/under/tomb/cave)
"Xc" = (
/obj/item/grown/log/tree/small,
/turf/open/floor/naturalstone,
/area/under/tomb/cave)
"XK" = (
/turf/open/floor/dirt/road,
/area/under/tomb)
"XO" = (
/obj/structure/flora/shroom_tree,
/turf/open/water/swamp,
/area/under/tomb/cave)
"XW" = (
/turf/closed/wall/mineral/decostone,
/area/under/tomb/cave)
"Yg" = (
/obj/structure/closet/dirthole/closed,
/obj/effect/mapping_helpers/structure/grave_spawner,
/turf/open/floor/dirt/road,
/area/under/tomb)

(1,1,1) = {"
iR
iR
iR
iR
iR
iR
iR
iR
iR
iR
iR
iR
CM
CM
GJ
CM
iR
iR
iR
iR
iR
iR
iR
iR
iR
iR
iR
iR
iR
iR
"}
(2,1,1) = {"
iR
iR
iR
iR
iR
iR
iR
iR
iR
iR
To
To
CM
CM
CM
CM
CM
CM
aH
iR
iR
iR
iR
iR
iR
iR
iR
iR
iR
iR
"}
(3,1,1) = {"
iR
iR
iR
iR
iR
iR
iR
iR
iR
iR
iR
Nq
Nq
To
CM
CM
To
aH
iR
iR
iR
iR
CI
Nq
iR
iR
iR
iR
iR
iR
"}
(4,1,1) = {"
iR
iR
iR
iR
iR
iR
iR
iR
iR
iR
iR
iR
iR
kp
To
CM
CM
Nq
Nq
To
iR
To
aH
CM
iR
iR
iR
iR
iR
iR
"}
(5,1,1) = {"
iR
iR
iR
iR
iR
iR
iR
iR
iR
iR
iR
iR
iR
To
To
To
Nq
Nq
XO
Nq
Nq
aH
aH
XW
iR
iR
iR
iR
iR
iR
"}
(6,1,1) = {"
iR
iR
iR
iR
iR
iR
iR
iR
iR
iR
iR
iR
iR
iR
Nq
Nq
vl
XO
Nq
Nq
aH
aH
aH
aH
To
iR
iR
iR
iR
iR
"}
(7,1,1) = {"
iR
iR
iR
iR
iR
iR
iR
iR
iR
iR
iR
iR
iR
iR
iR
XO
Nq
Nq
Nq
To
Sk
tc
aH
aH
aH
Bh
iR
iR
iR
iR
"}
(8,1,1) = {"
iR
iR
iR
iR
iR
iR
iR
iR
iR
iR
iR
iR
iR
iR
iR
iR
Nq
vl
To
CM
Sk
rp
aH
XW
aH
iR
iR
iR
iR
iR
"}
(9,1,1) = {"
iR
iR
iR
iR
iR
iR
iR
iR
iR
iR
iR
iR
iR
iR
iR
iR
iR
Nq
aH
CM
CM
aH
aH
iR
iR
iR
iR
iR
iR
iR
"}
(10,1,1) = {"
iR
iR
iR
iR
iR
iR
iR
iR
iR
iR
iR
in
dE
dE
iR
iR
iR
iR
iR
iR
iR
aH
To
iR
iR
iR
iR
iR
iR
iR
"}
(11,1,1) = {"
iR
iR
iR
iR
iR
iR
iR
iR
in
CZ
az
in
XK
XK
Lx
iR
iR
iR
iR
iR
iR
iR
Nq
XW
iR
iR
iR
iR
iR
iR
"}
(12,1,1) = {"
iR
iR
iR
iR
Qk
qH
yG
in
Lz
in
in
Lz
IP
Lx
Wk
Lx
iR
iR
iR
iR
iR
iR
iR
iR
iR
iR
iR
AG
XK
XK
"}
(13,1,1) = {"
XK
XK
CZ
wu
in
in
ip
XK
XK
XK
XK
XK
At
XK
XK
XK
Lz
XK
CZ
CZ
hY
AG
iR
iR
Rk
Yg
XK
XK
XK
XK
"}
(14,1,1) = {"
XK
in
Lz
Lz
in
XK
XK
fy
XK
XK
iR
in
in
XK
in
XK
XK
XK
XK
in
XK
XK
XK
nB
XK
in
Lz
iR
Lx
XK
"}
(15,1,1) = {"
in
in
XK
XK
XK
XK
Lx
XK
XK
fy
XK
XK
qH
Lz
in
CZ
iR
wu
XK
XK
ip
in
XK
XK
in
in
XK
in
XK
XK
"}
(16,1,1) = {"
vH
XK
XK
ip
XK
fy
XK
Lz
CZ
in
XK
TC
XK
in
wu
iR
lA
XK
XK
XK
XK
in
Lz
Lx
in
XK
XK
XK
in
SY
"}
(17,1,1) = {"
XK
XK
XK
XK
XK
XK
in
AG
De
iR
qH
XK
fy
XK
in
in
in
XK
Lz
in
in
XK
XK
nB
Lx
XK
Lz
in
in
in
"}
(18,1,1) = {"
XK
XK
XK
fy
XK
in
qH
oM
iR
iR
xy
ip
XK
iR
iR
OW
XK
XK
XK
XK
XK
cc
XK
XK
XK
XK
Yg
Yg
iR
iR
"}
(19,1,1) = {"
iR
XK
XK
XK
XK
in
in
xP
iR
CZ
XK
lA
iR
iR
iR
iR
Yg
in
qH
fy
XK
XK
XK
Lx
DA
iR
iR
iR
iR
iR
"}
(20,1,1) = {"
iR
XK
XK
Ft
ip
XK
XK
XK
XK
XK
XK
CZ
iR
iR
iR
iR
Lz
in
XK
xP
rr
Lz
if
nB
iR
iR
iR
iR
iR
iR
"}
(21,1,1) = {"
iR
iR
XK
fy
XK
Lx
AG
ip
XK
in
Lz
mj
iR
iR
iR
iR
Ts
iR
iR
iR
iR
iR
iR
iR
iR
iR
iR
Nq
iR
iR
"}
(22,1,1) = {"
iR
iR
in
XK
XK
XK
XK
XK
in
in
ew
iR
iR
iR
iR
iR
iR
iR
iR
iR
Nq
iL
iR
iR
CM
To
Nq
wj
Nq
iR
"}
(23,1,1) = {"
iR
iR
lA
Lz
Lz
IP
ip
gp
Lz
sF
iR
iR
iR
iR
iR
iR
iR
iR
iR
wj
Nq
CM
iR
nB
CM
tc
oB
To
iR
iR
"}
(24,1,1) = {"
iR
iR
iR
lA
in
in
in
in
CZ
iR
iR
iR
mu
iR
iR
iR
iR
iR
si
Nq
CM
CM
CM
iR
CM
rp
oB
To
vl
iR
"}
(25,1,1) = {"
iR
iR
iR
iR
lA
xP
iv
Ly
iR
iR
iR
aH
Nq
aH
iR
iR
iR
CM
CM
CM
CM
CM
CM
CM
CM
CM
To
To
Nq
iR
"}
(26,1,1) = {"
iR
iR
iR
iR
iR
iR
iR
iR
iR
iR
Nq
vl
Nq
Nq
Nq
CM
NC
NC
CM
CM
CM
CM
CM
CM
CM
To
Nq
iR
iR
iR
"}
(27,1,1) = {"
iR
iR
iR
iR
iR
iR
iR
iR
iR
iR
CM
Nq
WI
Nq
CM
NC
NC
NC
mJ
NC
CM
CM
iR
iR
Nq
Nq
Nq
AF
iR
iR
"}
(28,1,1) = {"
iR
iR
iR
iR
iR
iR
iR
iR
iR
iR
CM
CM
CM
CM
CM
NC
hQ
iR
iR
NC
mJ
iR
iR
iR
Nq
vl
iR
iR
iR
iR
"}
(29,1,1) = {"
iR
iR
iR
iR
iR
iR
iR
iR
iR
iR
iR
CM
CM
NC
NC
NC
hQ
iR
iR
Vc
hQ
NC
CM
Nq
Nq
iR
iR
iR
iR
iR
"}
(30,1,1) = {"
iR
iR
iR
iR
iR
iR
iR
iR
iR
iR
iR
iR
iR
NC
jc
NC
iR
iR
iR
iR
iR
iR
iR
iR
iR
iR
iR
iR
iR
iR
"}

(1,1,2) = {"
iR
iR
iR
iR
iR
iR
iR
iR
iR
iR
iR
iR
iR
aH
aH
aH
iR
iR
iR
iR
iR
iR
iR
iR
iR
iR
iR
iR
iR
iR
"}
(2,1,2) = {"
iR
iR
iR
iR
iR
iR
iR
iR
iR
iR
iR
iR
aG
aH
aH
aH
aH
Js
Js
To
Bh
Bh
Nq
Nq
Nq
GC
GC
GC
iR
iR
"}
(3,1,2) = {"
iR
iR
iR
Oh
vg
Dz
Pt
iR
iR
iR
iR
iR
iR
aH
aH
aH
Js
Js
To
To
CM
OL
Fy
CI
iR
iR
GC
GC
GC
iR
"}
(4,1,2) = {"
iR
iR
iR
Pt
Co
vg
Co
eL
mu
iR
iR
mu
aH
aH
aH
aH
Js
Js
Js
Js
To
To
To
SP
CM
iR
iR
GC
Cj
iR
"}
(5,1,2) = {"
iR
iR
iR
iR
bo
MV
aH
aH
mu
iR
iR
iR
aH
Nr
aH
Js
Js
Js
Js
Js
Js
Js
CM
CM
CM
Nq
iR
iR
EP
iR
"}
(6,1,2) = {"
iR
iR
iR
iR
aH
Co
vd
aH
iR
iR
iR
mu
aH
iR
CM
Js
Js
Js
Js
Js
Js
Js
aH
CM
CM
CM
Nq
iR
iR
iR
"}
(7,1,2) = {"
iR
iR
iR
iR
vd
aH
iR
aH
iR
iR
iR
iR
aH
To
CM
iR
iR
Js
Js
Js
Js
Sk
pr
pr
pr
To
Nq
Nq
iR
iR
"}
(8,1,2) = {"
iR
iR
iR
aH
gZ
iR
aH
aH
iR
iR
iR
iR
iR
iR
To
iR
iR
Js
Js
Js
Js
Sk
pr
pr
pr
To
aG
iR
iR
iR
"}
(9,1,2) = {"
iR
iR
iR
iR
iR
iR
yN
iR
iR
iR
iR
iR
iR
iR
aH
iR
iR
iR
Js
Js
iR
iR
iR
pr
pr
aH
To
aH
iR
iR
"}
(10,1,2) = {"
iR
iR
iR
iR
iR
iR
yN
iR
iR
iR
iR
Js
Js
Js
aH
iR
iR
iR
iR
iR
iR
iR
iR
pr
pr
aH
iR
iR
iR
iR
"}
(11,1,2) = {"
iR
iR
iR
iR
iR
mu
aH
iR
Js
Js
Js
Js
Js
Js
aH
iR
iR
iR
iR
iR
iR
iR
iR
pr
pr
aH
mu
iR
iR
iR
"}
(12,1,2) = {"
vg
iR
iR
iR
aH
aH
vg
iR
Js
Js
Js
Js
Js
Js
aH
aH
iR
iR
iR
iR
iR
iR
pr
pr
pr
aH
aH
aH
iR
iR
"}
(13,1,2) = {"
aH
aH
CM
CM
CM
aH
aH
aH
aH
Js
Js
Js
Js
Js
Js
aH
iR
iR
Js
Js
Js
Js
pr
pr
pr
Js
iR
aH
iR
iR
"}
(14,1,2) = {"
aH
CM
CM
CM
CM
CM
CM
aH
aH
Js
aH
aH
Js
Js
vg
aH
iR
Js
Js
Js
Js
Js
pr
pr
pr
Js
Js
aH
aH
aH
"}
(15,1,2) = {"
CM
CM
To
To
kh
CM
iR
iR
Js
Js
Js
Xc
Js
Js
Js
iR
iR
Js
Js
Js
Js
Js
pr
pr
pr
Js
Js
Js
aH
aH
"}
(16,1,2) = {"
To
To
To
iR
iR
iR
iR
iR
Js
Js
Js
iR
iR
Js
iR
iR
Js
Js
Js
Js
Js
Js
pr
pr
pr
Js
Js
Js
Js
aH
"}
(17,1,2) = {"
To
CM
CM
iR
iR
iR
vg
aH
aH
aH
Js
iR
iR
iR
iR
iR
Js
Js
Js
Js
Js
Js
pr
pr
pr
Js
Js
Js
aH
aH
"}
(18,1,2) = {"
iR
iR
CM
CM
CM
CM
To
To
aH
ah
iR
iR
iR
iR
iR
iR
iR
Js
Js
Js
Js
Js
pr
pr
pr
Js
Js
aH
aH
iR
"}
(19,1,2) = {"
iR
iR
iR
iR
iR
CM
CM
To
To
iR
iR
iR
iR
iR
iR
iR
iR
iR
iR
Js
Js
Js
pr
pr
pr
iR
iR
iR
iR
iR
"}
(20,1,2) = {"
iR
iR
iR
iR
iR
aH
CM
fm
iR
iR
iR
iR
aG
iR
gT
vg
iR
iR
iR
iR
iR
iR
pr
pr
pr
iR
iR
iR
iR
iR
"}
(21,1,2) = {"
iR
iR
iR
aH
aH
aH
xc
iR
iR
iR
aH
dr
aH
iR
iR
AQ
iR
iR
iR
iR
iR
iR
pr
pr
iR
iR
iR
iR
iR
iR
"}
(22,1,2) = {"
iR
BF
aH
aH
iR
iR
iR
iR
iR
iR
aH
iR
aH
IB
iR
aH
iR
iR
iR
iR
Js
Js
pr
pr
iR
iR
iR
iR
iR
iR
"}
(23,1,2) = {"
iR
aH
aH
iR
iR
iR
IB
iR
iR
iR
aH
iR
aH
iR
iR
Eq
aH
iR
iR
Js
Js
Js
pr
pr
pr
oB
Js
iR
iR
iR
"}
(24,1,2) = {"
iR
aH
iR
iR
iR
iR
aH
iR
eK
aH
aG
iR
mN
aH
iR
iR
aH
iR
iR
Js
Js
Js
pr
pr
pr
oB
Js
Js
iR
iR
"}
(25,1,2) = {"
iR
aH
aH
aH
aH
aG
aH
iR
aH
iR
iR
iR
iR
aG
iR
iR
aH
iR
iR
iR
Js
Js
Js
Js
Js
Js
Js
Js
iR
iR
"}
(26,1,2) = {"
iR
aH
iR
iR
iR
aH
iR
iR
aH
aH
aH
aH
aH
aH
aH
iR
aH
iR
iR
Js
Js
Js
Js
Js
Js
Js
Js
iR
iR
iR
"}
(27,1,2) = {"
iR
aH
iR
iR
iR
aH
tW
aH
zU
AQ
iR
iR
aH
vg
aH
aH
aH
iR
iR
iR
Js
Js
aH
aH
Js
iR
iR
iR
iR
iR
"}
(28,1,2) = {"
iR
aH
aH
aH
iR
aH
iR
iR
iR
iR
iR
iR
iR
iR
iR
aH
aH
Cq
iR
iR
Js
Ei
aH
DH
iR
iR
iR
iR
iR
iR
"}
(29,1,2) = {"
iR
iR
iR
aG
vg
aH
iR
iR
iR
iR
iR
iR
iR
iR
iR
aH
aH
vg
iR
iR
iR
MX
bd
iR
iR
iR
iR
iR
iR
iR
"}
(30,1,2) = {"
iR
iR
iR
iR
iR
iR
iR
iR
iR
iR
iR
iR
iR
iR
aH
aH
aH
iR
iR
iR
iR
iR
iR
iR
iR
iR
iR
iR
iR
iR
"}
